##-------
-------#-
---------
-#---#---
---------
-----#---
--#------
----#----
--##-----
