---------
-###-----
-#-------
---------
-----###-
-#-------
-#-------
-----#---
---------
