--------#
---#----#
---#-----
---#-----
---#-----
---------
##-------
-----#---
#--------
