-#-#--#-#-----#----#----#---
------------------###---##--
---#--------###-#----------#
##-----#-----#----#######---
#-----##-----##-------------
--#-#-----#---------#------#
#--#----------#-----#--##---
-------##-----#---#--#------
---#-#----#-#-##---#-##--#--
-----#-----#-#-----------#--
---------#-##-#-#--------#--
--#------------------#------
#--------##-----------##----
----#------#---#--------##--
---#--#---#----------------#
----------#-##------#----#--
