-----------#----#-#---------
---#-------#---#-#--#-#---#-
-----------##-----#-#-----#-
-#-#---#----#-#--##--##---##
-----------------##----#---#
#----------#---------------#
---#--------------#-------#-
--#----##-##-----#--#-##----
--##----#----------#--------
----##--------#----#-#-----#
---#--------##------#----#--
-#-#----##-------------#--#-
##-----#--#------##---------
---#------#-#--------##-#---
-##----##--#--------#-------
#----##---#--###------------
