-------#-------##---#-#-----
#-------##--#-----------#---
-#---#----------##-----#--#-
---#-----------#----#----#--
-----###------##------#-----
--#--#--##-----------#------
---------##-#---------------
-##-###---#--#---#---#------
--#-#--##----------#-------#
---#-####-#-###-------------
#---------------------------
--#-###--###---------#----#-
------#---##--#-----#------#
--------#-----##---#-#------
-#--#-#------#-#--#----##--#
-------#------------#-#-#-#-
