-#--------------
---------#-#-#--
-#-----#--------
------#--#------
-------------#--
#---------------
------#------#--
#-#---#---------
--#--#---#------
#--#--#--#---#--
----------------
--#------#------
--##----#--#----
#-----##-#------
##-----#---#----
--#----#-----#--
