----------------
--#-----#--##---
---#-----#------
---#---#----#---
----#-#---------
----------#--#--
#----------#----
----------#---#-
----#----##-----
--#--------#----
---#------------
-#-#--#------#--
----#---#-------
----#-------#--#
--------##-#---#
--#---#-#----#--
