--####-------#--
-----##--#------
------#------#--
------###-------
--#-----#-------
-------------#--
--#-----#-------
--#-----#-------
--------#-------
---##------##---
------#----#----
------#----#----
-----##----###--
------#---------
----###----#----
----#-----------
